root	root
root|卫生健康	卫生健康
root|卫生健康|卫生行政许可审批	卫生行政许可审批
root|卫生健康|卫生行政许可审批|公共场所卫生许可	公共场所卫生许可
root|卫生健康|卫生行政许可审批|消毒产品企业卫生许可	消毒产品企业卫生许可
root|卫生健康|卫生行政许可审批|职业卫生许可	职业卫生许可
root|卫生健康|卫生行政许可审批|生活饮用水卫生许可	生活饮用水卫生许可
root|卫生健康|开具证明	开具证明
root|卫生健康|开具证明|诊断证明	诊断证明
root|卫生健康|开具证明|其他证明	其他证明
root|卫生健康|开具证明|死亡医学证明	死亡医学证明
root|民政事务	民政事务
root|民政事务|社会救助	社会救助
root|民政事务|社会救助|五保户	五保户
root|民政事务|社会救助|城乡低保	城乡低保
root|民政事务|社会救助|特困人员供养	特困人员供养
root|民政事务|社会救助|低收入家庭救助	低收入家庭救助
root|民政事务|养老	养老
root|民政事务|养老|特殊养老服务补贴	特殊养老服务补贴
root|民政事务|养老|居家养老	居家养老
root|民政事务|养老|社区养老	社区养老
root|民政事务|养老|养老机构收费和服务	养老机构收费和服务
root|民政事务|养老|北京通养老助残卡	北京通养老助残卡
root|民政事务|养老|老年餐桌	老年餐桌
root|民政事务|婚姻	婚姻
root|民政事务|婚姻|登记	登记
root|民政事务|婚姻|补办证件	补办证件
root|民政事务|残疾人服务	残疾人服务
root|民政事务|残疾人服务|无障碍环境	无障碍环境
root|民政事务|残疾人服务|其他政策咨询	其他政策咨询
root|民政事务|残疾人服务|残疾人入住福利机构补贴	残疾人入住福利机构补贴
root|民政事务|残疾人服务|就业	就业
root|民政事务|残疾人服务|机动轮椅车	机动轮椅车
root|民政事务|残疾人服务|法律服务	法律服务
root|民政事务|残疾人服务|北京通养老助残卡	北京通养老助残卡
root|民政事务|残疾人服务|保险	保险
root|民政事务|残疾人服务|机动车	机动车
root|民政事务|残疾人服务|康复与辅具	康复与辅具
root|民政事务|残疾人服务|残疾人证	残疾人证
root|民政事务|残疾人服务|困难残疾人生活补贴和重度残疾人护理补贴	困难残疾人生活补贴和重度残疾人护理补贴
root|民政事务|收养	收养
root|民政事务|收养|被收养人户口申报	被收养人户口申报
root|民政事务|收养|条件	条件
root|退役军人事务	退役军人事务
root|退役军人事务|退役军人安置	退役军人安置
root|退役军人事务|退役军人安置|转业安置	转业安置
root|退役军人事务|退役军人安置|自主择业	自主择业
root|退役军人事务|退役军人安置|退伍安置	退伍安置
root|违纪举报	违纪举报
root|违纪举报|形式主义、官僚主义突出问题	形式主义、官僚主义突出问题
root|违纪举报|形式主义、官僚主义突出问题|联系群众、服务群众方面	联系群众、服务群众方面
root|违纪举报|形式主义、官僚主义突出问题|在履职尽责、服务经济社会发展方面	在履职尽责、服务经济社会发展方面
root|违纪举报|形式主义、官僚主义突出问题|涉及落实全面从严治党主体责任、监督责任不力问题的信访举报	涉及落实全面从严治党主体责任、监督责任不力问题的信访举报
root|住房	住房
root|住房|房屋权属	房屋权属
root|住房|房屋权属|产权过户	产权过户
root|住房|房屋权属|房屋档案	房屋档案
root|住房|房屋权属|产权证	产权证
root|住房|房屋权属|房产继承	房产继承
root|住房|房屋权属|产权抵押	产权抵押
root|住房|房改	房改
root|住房|房改|住房补贴	住房补贴
root|住房|房改|福利分房	福利分房
root|住房|房改|集资建房	集资建房
root|住房|住房公积金	住房公积金
root|住房|住房公积金|查询	查询
root|住房|住房公积金|提取	提取
root|住房|住房公积金|政策	政策
root|住房|住房公积金|缴纳	缴纳
root|住房|老楼改造	老楼改造
root|住房|老楼改造|环境改造	环境改造
root|住房|老楼改造|接通燃气	接通燃气
root|住房|老楼改造|加装电梯	加装电梯
root|住房|老楼改造|工程进度	工程进度
root|住房|老楼改造|管线改造	管线改造
root|住房|老楼改造|抗震加固	抗震加固
root|住房|老楼改造|工程质量	工程质量
root|住房|老楼改造|节能保温	节能保温
root|住房|老楼改造|申请	申请
root|住房|央产房	央产房
root|住房|房屋修缮	房屋修缮
root|住房|房屋修缮|墙体、地面开裂	墙体、地面开裂
root|住房|房屋修缮|下水管道堵塞	下水管道堵塞
root|住房|房屋修缮|平改坡	平改坡
root|住房|房屋修缮|房屋滴漏	房屋滴漏
root|住房|小区配套	小区配套
root|住房|小区配套|健身器材	健身器材
root|住房|小区配套|停车位	停车位
root|住房|小区配套|地锁	地锁
root|住房|小区配套|电梯	电梯
root|住房|小区配套|电动汽车充电设施安装与管理	电动汽车充电设施安装与管理
root|住房|小区配套|门禁	门禁
root|住房|小区配套|会所	会所
root|住房|小区配套|道路	道路
root|住房|小区配套|人防工程（人防工程、防空地下室、防空洞）	人防工程（人防工程、防空地下室、防空洞）
root|住房|小区配套|学校	学校
root|住房|小区配套|下水	下水
root|住房|小区配套|普通地下室	普通地下室
root|住房|小区配套|柜式售水机/自动售水机	柜式售水机/自动售水机
root|住房|小区配套|无障碍设施	无障碍设施
root|住房|小区配套|监控	监控
root|住房|小区配套|电动自行车充电设施安装与管理	电动自行车充电设施安装与管理
root|住房|小区配套|公共绿地	公共绿地
root|住房|小区配套|公共照明	公共照明
root|住房|住房困难	住房困难
root|住房|危房改造	危房改造
root|住房|非法出租房屋	非法出租房屋
root|住房|非法出租房屋|群租房	群租房
root|住房|非法出租房屋|民宅商用	民宅商用
root|住房|非法出租房屋|公房出租	公房出租
root|住房|房产中介	房产中介
root|住房|房产中介|提供虚假信息	提供虚假信息
root|住房|房产中介|合同纠纷	合同纠纷
root|住房|房产中介|收费不合理	收费不合理
root|住房|房产中介|房地产租赁经纪	房地产租赁经纪
root|住房|房产中介|服务水平差	服务水平差
root|住房|房产中介|黑中介	黑中介
root|住房|房产中介|房产中介网站	房产中介网站
root|住房|小区规划	小区规划
root|住房|小区规划|小区内绿地	小区内绿地
root|住房|小区规划|楼间距	楼间距
root|住房|小区规划|小区内停车设施	小区内停车设施
root|住房|小区规划|容积率	容积率
root|住房|小区规划|日照	日照
root|住房|其他	其他
root|住房|房屋交易	房屋交易
root|住房|房屋交易|交易纠纷	交易纠纷
root|住房|房屋交易|租赁备案	租赁备案
root|住房|房屋交易|稳定房价措施	稳定房价措施
root|住房|房屋交易|程序手续	程序手续
root|住房|房屋交易|违规销售	违规销售
root|住房|商品房	商品房
root|住房|商品房|销售欺诈	销售欺诈
root|住房|商品房|购买条件	购买条件
root|住房|商品房|品质	品质
root|住房|商品房|项目审批	项目审批
root|住房|商品房|预售资格	预售资格
root|住房|商品房|交易	交易
root|住房|住房保障	住房保障
root|住房|住房保障|廉租房	廉租房
root|住房|住房保障|自住型商品房	自住型商品房
root|住房|住房保障|两限房	两限房
root|住房|住房保障|公租房	公租房
root|住房|住房保障|共有产权住房	共有产权住房
root|住房|住房保障|经济适用房	经济适用房
root|科体文宣	科体文宣
root|科体文宣|体育	体育
root|科体文宣|体育|体育产业发展	体育产业发展
root|科体文宣|体育|群众体育活动	群众体育活动
root|科体文宣|体育|竞技体育活动	竞技体育活动
root|科体文宣|体育|体育设施规划建设	体育设施规划建设
root|科体文宣|体育|体育彩票	体育彩票
root|科体文宣|科技	科技
root|科体文宣|科技|科技应用推广	科技应用推广
root|科体文宣|文化	文化
root|科体文宣|文化|公共文化设施（博物馆、图书馆、影剧院等）	公共文化设施（博物馆、图书馆、影剧院等）
root|科体文宣|文化|文化市场管理（演出演艺、出版物展销会等）	文化市场管理（演出演艺、出版物展销会等）
root|科体文宣|文化|文娱场所管理（歌舞厅、棋牌室、网吧等）	文娱场所管理（歌舞厅、棋牌室、网吧等）
root|科体文宣|文化|未经许可从事文物经营或拍卖	未经许可从事文物经营或拍卖
root|科体文宣|文化|互联网上网服务营业场所	互联网上网服务营业场所
root|科体文宣|文化|盗版图书、违禁出版物	盗版图书、违禁出版物
root|科体文宣|文化|非物质文化遗产保护	非物质文化遗产保护
root|科体文宣|文化|网络游戏	网络游戏
root|科体文宣|文化|文物市场管理	文物市场管理
root|科体文宣|文化|其他	其他
root|科体文宣|文化|文化体制改革	文化体制改革
root|科体文宣|文化|文物保护	文物保护
root|科体文宣|文化|古代物质文化遗产	古代物质文化遗产
root|科体文宣|文化|网络视听（网络直播、视频网站、网络表演等）	网络视听（网络直播、视频网站、网络表演等）
root|科体文宣|广播电视	广播电视
root|科体文宣|广播电视|电影	电影
root|科体文宣|广播电视|广播	广播
root|科体文宣|广播电视|新闻报刊	新闻报刊
root|科体文宣|广播电视|图书音像	图书音像
root|科体文宣|广播电视|电视	电视
root|科体文宣|其他	其他
root|教育	教育
root|教育|教育帮扶	教育帮扶
root|教育|教育帮扶|求助救助	求助救助
root|教育|教育帮扶|教育基金	教育基金
root|教育|学前教育	学前教育
root|教育|学前教育|幼师资质	幼师资质
root|教育|学前教育|幼儿园入园	幼儿园入园
root|教育|学前教育|增设公立、普惠幼儿园	增设公立、普惠幼儿园
root|教育|学前教育|校园管理	校园管理
root|教育|出国留学	出国留学
root|教育|出国留学|中介机构	中介机构
root|教育|出国留学|预科培训机构消费纠纷	预科培训机构消费纠纷
root|教育|出国留学|学历认定	学历认定
root|教育|社会办学	社会办学
root|教育|社会办学|成人教育	成人教育
root|教育|社会办学|民办学校	民办学校
root|教育|校所建设	校所建设
root|教育|校所建设|改造修缮	改造修缮
root|教育|校所建设|设施完善	设施完善
root|教育|校所建设|新建增设	新建增设
root|教育|社会实践	社会实践
root|教育|社会实践|交流	交流
root|教育|社会实践|实习	实习
root|教育|其他	其他
root|教育|后勤保障	后勤保障
root|教育|后勤保障|食堂餐饮	食堂餐饮
root|教育|后勤保障|校车	校车
root|教育|后勤保障|课后托管	课后托管
root|教育|后勤保障|宿舍管理	宿舍管理
root|教育|后勤保障|校园安全	校园安全
root|教育|后勤保障|环境卫生	环境卫生
root|教育|教育收费	教育收费
root|教育|教育收费|收费不合理	收费不合理
root|教育|教育收费|非义务教育阶段	非义务教育阶段
root|教育|入学升学	入学升学
root|教育|入学升学|学区划片	学区划片
root|教育|入学升学|高考	高考
root|教育|入学升学|非京籍	非京籍
root|教育|入学升学|幼升小	幼升小
root|教育|入学升学|入托入园	入托入园
root|教育|入学升学|失学辍学	失学辍学
root|教育|入学升学|人户分离	人户分离
root|教育|入学升学|中考	中考
root|教育|入学升学|小升初	小升初
root|教育|教职人员管理	教职人员管理
root|教育|教职人员管理|师资力量	师资力量
root|教育|教职人员管理|师德师风	师德师风
root|教育|教职人员管理|工资待遇	工资待遇
root|教育|教职人员管理|继续教育	继续教育
root|教育|教职人员管理|民办代课教师	民办代课教师
root|教育|教职人员管理|职称评定	职称评定
root|教育|教务管理	教务管理
root|教育|教务管理|校园活动	校园活动
root|教育|教务管理|考试安排	考试安排
root|教育|教务管理|教学水平	教学水平
root|教育|教务管理|违规补课	违规补课
root|教育|教务管理|课程安排	课程安排
root|教育|教务管理|学历查询	学历查询
root|教育|教务管理|学籍管理	学籍管理
root|交通管理	交通管理
root|交通管理|道路运输	道路运输
root|交通管理|道路运输|运输许可证	运输许可证
root|交通管理|车辆管理	车辆管理
root|交通管理|车辆管理|车辆信息查询	车辆信息查询
root|交通管理|车辆管理|车辆报废	车辆报废
root|交通管理|车辆管理|车辆过户	车辆过户
root|交通管理|车辆管理|车辆登记	车辆登记
root|交通管理|车辆管理|机动车维修服务质量	机动车维修服务质量
root|交通管理|车辆管理|私改车辆	私改车辆
root|政务失信投诉举报	政务失信投诉举报
root|政务失信投诉举报|政府和社会资本合作	政府和社会资本合作
root|政务失信投诉举报|政府和社会资本合作|不履行合同约定义务	不履行合同约定义务
root|政务失信投诉举报|政府和社会资本合作|公务人员行政不作为	公务人员行政不作为
root|政务失信投诉举报|政府采购	政府采购
root|政务失信投诉举报|政府采购|公务人员行政不作为	公务人员行政不作为
root|政务失信投诉举报|招标投标	招标投标
root|政务失信投诉举报|招标投标|信息不公开透明或存在错误	信息不公开透明或存在错误
root|环境保护	环境保护
root|环境保护|环保审批	环保审批
root|企业服务	企业服务
root|企业服务|投诉举报	投诉举报
root|企业服务|投诉举报|违法违纪	违法违纪
root|企业服务|投诉举报|行政处罚	行政处罚
root|企业服务|投诉举报|行政执法	行政执法
root|企业服务|投诉举报|办事服务	办事服务
root|企业服务|投诉举报|体制机制	体制机制
root|企业服务|公共服务	公共服务
root|企业服务|公共服务|供电管理	供电管理
root|企业服务|公共服务|供暖管理	供暖管理
root|企业服务|公共服务|宽带网络	宽带网络
root|企业服务|公共服务|水务管理	水务管理
root|企业服务|公共服务|燃气管理	燃气管理
root|企业服务|公共服务|用水价格和指标	用水价格和指标
root|企业服务|文体科教	文体科教
root|企业服务|文体科教|体育	体育
root|企业服务|文体科教|电影	电影
root|企业服务|文体科教|出版发行	出版发行
root|企业服务|文体科教|演出娱乐	演出娱乐
root|企业服务|文体科教|科技评定	科技评定
root|企业服务|文体科教|教育培训资质	教育培训资质
root|企业服务|文体科教|旅游行业管理	旅游行业管理
root|企业服务|文体科教|艺术	艺术
root|企业服务|文体科教|广播电视	广播电视
root|企业服务|文体科教|网络文化	网络文化
root|企业服务|建筑住房	建筑住房
root|企业服务|建筑住房|物业和房屋中介管理	物业和房屋中介管理
root|企业服务|建筑住房|建筑施工招投标	建筑施工招投标
root|企业服务|建筑住房|保障性住房	保障性住房
root|企业服务|建筑住房|拆迁腾退	拆迁腾退
root|企业服务|建筑住房|建筑工程	建筑工程
root|企业服务|建筑住房|建筑业人员管理	建筑业人员管理
root|企业服务|建筑住房|住房管理	住房管理
root|企业服务|建筑住房|建筑企业资质	建筑企业资质
root|企业服务|人事人才	人事人才
root|企业服务|人事人才|特殊工种工时	特殊工种工时
root|企业服务|人事人才|涉外从业人员	涉外从业人员
root|企业服务|人事人才|工作居住证	工作居住证
root|企业服务|人事人才|退休人员	退休人员
root|企业服务|人事人才|其他户口问题	其他户口问题
root|企业服务|人事人才|职业培训资质	职业培训资质
root|企业服务|人事人才|人事档案	人事档案
root|企业服务|人事人才|积分落户	积分落户
root|企业服务|人事人才|培训与岗位补贴	培训与岗位补贴
root|企业服务|人事人才|劳动合同	劳动合同
root|企业服务|人事人才|人才引进	人才引进
root|企业服务|人事人才|职介派遣	职介派遣
root|企业服务|人事人才|待遇标准	待遇标准
root|企业服务|人事人才|公积金和住房补贴	公积金和住房补贴
root|企业服务|环保节能	环保节能
root|企业服务|环保节能|节能减排	节能减排
root|企业服务|环保节能|污染物排放	污染物排放
root|企业服务|环保节能|环境评价	环境评价
root|企业服务|合同纠纷	合同纠纷
root|企业服务|合同纠纷|其他纠纷	其他纠纷
root|企业服务|合同纠纷|企业间合同纠纷（不含电商平台企业）	企业间合同纠纷（不含电商平台企业）
root|企业服务|网站系统	网站系统
root|企业服务|网站系统|反映系统内容有误	反映系统内容有误
root|企业服务|网站系统|其他网站系统操作问题	其他网站系统操作问题
root|企业服务|网站系统|e窗通	e窗通
root|企业服务|民政司法	民政司法
root|企业服务|民政司法|司法审查	司法审查
root|企业服务|民政司法|社会组织	社会组织
root|企业服务|民政司法|公益福利	公益福利
root|企业服务|民政司法|司法公证	司法公证
root|企业服务|民政司法|殡葬养老	殡葬养老
root|企业服务|民政司法|残疾人保障	残疾人保障
root|企业服务|医卫健康	医卫健康
root|企业服务|医卫健康|中医管理	中医管理
root|企业服务|医卫健康|医护人员管理	医护人员管理
root|企业服务|医卫健康|药品保健品	药品保健品
root|企业服务|医卫健康|医保定点	医保定点
root|企业服务|医卫健康|医疗器械	医疗器械
root|企业服务|医卫健康|医护机构资质	医护机构资质
root|企业服务|医卫健康|公共卫生	公共卫生
root|企业服务|市场管理	市场管理
root|企业服务|市场管理|迁入迁出	迁入迁出
root|企业服务|市场管理|反映违法违规	反映违法违规
root|企业服务|市场管理|信用管理	信用管理
root|企业服务|市场管理|注销破产	注销破产
root|企业服务|市场管理|开具证明	开具证明
root|企业服务|市场管理|合同章程	合同章程
root|企业服务|市场管理|政策规定（公司法）	政策规定（公司法）
root|企业服务|市场管理|注册设立	注册设立
root|企业服务|市场管理|营业执照	营业执照
root|企业服务|市场管理|广告管理	广告管理
root|企业服务|市场管理|抵押质押	抵押质押
root|企业服务|市场管理|食品管理	食品管理
root|企业服务|市场管理|备案	备案
root|企业服务|市场管理|变更	变更
root|企业服务|市场管理|经营异常	经营异常
root|企业服务|市场管理|年报年审	年报年审
root|企业服务|市场管理|特种设备	特种设备
root|企业服务|规划与工程建设	规划与工程建设
root|企业服务|规划与工程建设|测绘与地质	测绘与地质
root|企业服务|规划与工程建设|旅游投资项目	旅游投资项目
root|企业服务|规划与工程建设|工程建设施工	工程建设施工
root|企业服务|规划与工程建设|市政设施建设	市政设施建设
root|企业服务|规划与工程建设|土地规划（含交易）	土地规划（含交易）
root|企业服务|档案统计	档案统计
root|企业服务|档案统计|统计调查	统计调查
root|企业服务|档案统计|企业档案	企业档案
root|企业服务|优惠和奖励政策	优惠和奖励政策
root|企业服务|优惠和奖励政策|其他优惠和奖励政策	其他优惠和奖励政策
root|企业服务|优惠和奖励政策|科技产业政策	科技产业政策
root|企业服务|优惠和奖励政策|文化产业政策	文化产业政策
root|企业服务|商贸服务	商贸服务
root|企业服务|商贸服务|展览展会	展览展会
root|企业服务|商贸服务|商业流通	商业流通
root|企业服务|商贸服务|境外投资	境外投资
root|企业服务|商贸服务|进出口贸易	进出口贸易
root|企业服务|商贸服务|生活服务	生活服务
root|企业服务|查询信息	查询信息
root|企业服务|查询信息|政府地址电话	政府地址电话
root|企业服务|查询信息|其他信息	其他信息
root|企业服务|查询信息|核实机构	核实机构
root|企业服务|安防管理	安防管理
root|企业服务|安防管理|人防工程	人防工程
root|企业服务|安防管理|消防	消防
root|企业服务|安防管理|公章管理（含电子章）	公章管理（含电子章）
root|企业服务|安防管理|特种行业	特种行业
root|企业服务|安防管理|安全生产	安全生产
root|企业服务|安防管理|危化品管理	危化品管理
root|企业服务|宗教文物	宗教文物
root|企业服务|宗教文物|民族宗教	民族宗教
root|企业服务|宗教文物|文物管理	文物管理
root|企业服务|交通运输	交通运输
root|企业服务|交通运输|小客车指标	小客车指标
root|企业服务|交通运输|公路管理	公路管理
root|企业服务|交通运输|停车管理	停车管理
root|企业服务|交通运输|车辆管理	车辆管理
root|企业服务|交通运输|物流运输资质	物流运输资质
root|企业服务|网络通信	网络通信
root|企业服务|网络通信|增值电信	增值电信
root|企业服务|网络通信|其他通信管理	其他通信管理
root|企业服务|网络通信|信息安全	信息安全
root|企业服务|知识产权	知识产权
root|企业服务|知识产权|专利权	专利权
root|企业服务|知识产权|商标权	商标权
root|企业服务|知识产权|其他知识产权	其他知识产权
root|企业服务|金融财政	金融财政
root|企业服务|金融财政|银行账户	银行账户
root|企业服务|金融财政|融资信贷	融资信贷
root|企业服务|金融财政|金融行业管理	金融行业管理
root|企业服务|金融财政|政府采购	政府采购
root|企业服务|城市管理	城市管理
root|企业服务|城市管理|生活垃圾	生活垃圾
root|企业服务|城市管理|户外广告	户外广告
root|企业服务|城市管理|市政市容	市政市容
root|企业服务|农林牧渔	农林牧渔
root|企业服务|农林牧渔|林业管理	林业管理
root|企业服务|农林牧渔|牧业管理	牧业管理
root|企业服务|农林牧渔|农业管理	农业管理
root|劳动和社会保障	劳动和社会保障
root|劳动和社会保障|离退休工资和待遇	离退休工资和待遇
root|劳动和社会保障|离退休工资和待遇|离休	离休
root|劳动和社会保障|离退休工资和待遇|病退及提前退休	病退及提前退休
root|劳动和社会保障|离退休工资和待遇|退休	退休
root|劳动和社会保障|档案管理	档案管理
root|劳动和社会保障|档案管理|退休人员档案管理	退休人员档案管理
root|劳动和社会保障|档案管理|流动人员档案管理	流动人员档案管理
root|劳动和社会保障|档案管理|失业人员档案管理	失业人员档案管理
root|劳动和社会保障|职业资格水平考试	职业资格水平考试
root|劳动和社会保障|就业	就业
root|劳动和社会保障|就业|招聘会	招聘会
root|劳动和社会保障|就业|灵活就业	灵活就业
root|劳动和社会保障|就业|就业难	就业难
root|劳动和社会保障|就业|就业指导	就业指导
root|劳动和社会保障|就业|人力资源市场管理服务	人力资源市场管理服务
root|劳动和社会保障|就业|就业政策	就业政策
root|劳动和社会保障|社会保险	社会保险
root|劳动和社会保障|社会保险|医疗保险	医疗保险
root|劳动和社会保障|社会保险|生育保险	生育保险
root|劳动和社会保障|社会保险|工伤保险	工伤保险
root|劳动和社会保障|社会保险|补充医疗保险	补充医疗保险
root|劳动和社会保障|社会保险|社保卡	社保卡
root|劳动和社会保障|社会保险|养老保险	养老保险
root|劳动和社会保障|社会保险|社保基金管理	社保基金管理
root|劳动和社会保障|社会保险|失业保险	失业保险
